GetMarktakteur.WebportalDesNetzbetreibers	hinzugefügt
FristverlaengerungGrundEnum.StilllegungsmeldungFehlt	hinzugefügt
GetListeMeineNetzbetreiberpruefungen.Netzbetreiberpruefung.AutomatischeDatenuebernahmeAm	hinzugefügt
GetMarktakteur.Registergericht	Typ geändert
GetMarktakteur.RegistergerichtAusland	Typ geändert
GetMarktakteur.Registernummer	Typ geändert
GetMarktakteur.RegisternummerAusland	Typ geändert
GetMarktakteur.RegisternummerPraefix	hinzugefügt
SetKorrekturVorschlagEinheitAnlagenbetreiber.Registergericht	Typ geändert
SetKorrekturVorschlagEinheitAnlagenbetreiber.RegistergerichtAusland	Typ geändert
SetKorrekturVorschlagEinheitAnlagenbetreiber.Registernummer	Typ geändert
SetKorrekturVorschlagEinheitAnlagenbetreiber.RegisternummerAusland	Typ geändert
SetKorrekturVorschlagEinheitAnlagenbetreiber.RegisternummerPraefix	hinzugefügt
GetKorrekturVorschlagEinheitAnlagenbetreiber.Registergericht	Typ geändert
GetKorrekturVorschlagEinheitAnlagenbetreiber.RegistergerichtAusland	Typ geändert
GetKorrekturVorschlagEinheitAnlagenbetreiber.Registernummer	Typ geändert
GetKorrekturVorschlagEinheitAnlagenbetreiber.RegisternummerAusland	Typ geändert
GetKorrekturVorschlagEinheitAnlagenbetreiber.RegisternummerPraefix	hinzugefügt
GetListeMeineNetzbetreiberpruefungen.AbgeschlosseneTicketprozesseEinschliessen	hinzugefügt
GetListeMeineNetzbetreiberpruefungen.Netzbetreiberpruefung.DatenaenderungsgrundFelder	hinzugefügt
SetKorrekturVorschlagEinheitGeothermieGrubengasDruckentspannung.energietraeger	hinzugefügt
SetKorrekturVorschlagEinheitGeothermieGrubengasDruckentspannung.energietraegerZuPruefen	hinzugefügt
GetKorrekturVorschlagEinheitGeothermieGrubengasDruckentspannung.energietraeger	hinzugefügt
GetKorrekturVorschlagEinheitGeothermieGrubengasDruckentspannung.energietraegerZuPruefen	hinzugefügt
GetMarktakteur.Status	hinzugefügt
GetEinheit(X).NetzbetreiberMastrNummer	entfernt
RollenEnum.SystemAdministrator -> Verwaltungsbetreuer	umbenannt
SetKorrekturVorschlagEinheitWind.eegMastrNummer	entfernt
SetKorrekturVorschlagEinheitWind.eegMastrNummerZuPruefen	entfernt
GetKorrekturVorschlagEinheitWind.eegMastrNummer	entfernt
GetKorrekturVorschlagEinheitWind.eegMastrNummerZuPruefen	entfernt
SetKorrekturVorschlagEinheitAnlagenbetreiber.Taetigkeitsbeginn	entfernt
SetKorrekturVorschlagEinheitAnlagenbetreiber.TaetigkeitsbeginnZuPruefen	entfernt
SetKorrekturVorschlagEinheitAnlagenbetreiber.Taetigkeitsende	entfernt
SetKorrekturVorschlagEinheitAnlagenbetreiber.TaetigkeitsendeZuPruefen	entfernt
GetKorrekturVorschlagEinheitAnlagenbetreiber.Taetigkeitsbeginn	entfernt
GetKorrekturVorschlagEinheitAnlagenbetreiber.TaetigkeitsbeginnZuPruefen	entfernt
GetKorrekturVorschlagEinheitAnlagenbetreiber.Taetigkeitsende	entfernt
GetKorrekturVorschlagEinheitAnlagenbetreiber.TaetigkeitsendeZuPruefen	entfernt
GetGefilterteListeStromErzeuger.SolarLage	hinzugefügt
GetGefilterteListe(X).Landkreis	hinzugefügt
GetGefilterteListe(X).Gemeinde	hinzugefügt
GetGefilterteListe(X).Gemeindeschluessel	hinzugefügt
TechnologieSpeicherEnum.Sonstiges	entfernt
GetEinheit(X).FernsteuerbarkeitDr	entfernt
GetKorrekturVorschlagEinheit(X).FernsteuerbarkeitDr	entfernt
SetKorrekturVorschlagEinheit(X).FernsteuerbarkeitDr	entfernt
GetEinheit(X).GemeinsamerWechselrichterMitSpeicher	entfernt
GetKorrekturVorschlagEinheit(X).GemeinsamerWechselrichterMitSpeicher	entfernt
SetKorrekturVorschlagEinheit(X).GemeinsamerWechselrichterMitSpeicher	entfernt
GetListeMeineNetzbetreiberpruefungen.Netzbetreiberpruefung.WeitereDatenaenderung	hinzugefügt
GetMarktakteur.Taetigkeitsende	Typ geändert, ist jetzt optional
TechnologieSpeicherEnum.Wasserstoffspeicher	hinzugefügt
GetEinheitStromSpeicher.PumpbetriebLeistungsaufnahme -> LeistungsaufnahmeBeimEinspeichern	umbenannt
GetKorrekturVorschlagEinheitStromSpeicher.LeistungsaufnahmeBeimEinspeichern -> LeistungsaufnahmeBeimEinspeichern	umbenannt
GetKorrekturVorschlagEinheitStromSpeicher.LeistungsaufnahmeBeimEinspeichernZuPruefen -> LeistungsaufnahmeBeimEinspeichernZuPruefen	umbenannt
SetKorrekturVorschlagEinheitStromSpeicher.LeistungsaufnahmeBeimEinspeichern -> LeistungsaufnahmeBeimEinspeichern	umbenannt
SetKorrekturVorschlagEinheitStromSpeicher.LeistungsaufnahmeBeimEinspeichernZuPruefen -> LeistungsaufnahmeBeimEinspeichernZuPruefen	umbenannt
SolarLageEnum.SteckerfertigeErzeugungsanlage -> SteckerfertigeSolaranlage	umbenannt
 GetEinheitSolar.Zaehlernummer	hinzugefügt
Marktakteur.Taetigkeitsende	Typ geändert